11 25 11 11 3 11 11 9 21 21 21 21 21 21 21 21 21 21 21 21 21 21 21 21 21 8 11 11 3 11 11 11 11 25 11 11 18 11 11 4 9 21 21 21 21 21 21 8 11 11 
11 1 11 11 11 7 6 16 21 21 21 21 21 21 21 21 21 21 21 21 21 21 21 21 21 17 6 6 6 5 11 11 18 1 11 11 11 11 11 11 9 21 21 21 21 21 21 8 11 18 
11 11 11 18 11 9 21 21 21 21 21 21 21 21 21 21 21 21 21 21 21 21 21 21 21 21 21 21 21 17 6 5 11 11 11 11 2 11 11 7 16 21 21 21 21 21 14 10 11 11 
4 11 11 11 7 16 21 21 21 21 21 21 21 21 21 21 21 21 21 21 21 21 21 21 21 21 21 21 21 21 21 17 6 6 6 6 6 6 6 16 21 21 21 21 21 21 8 11 11 4 
6 6 6 6 16 21 21 21 21 21 21 21 21 21 21 21 21 21 21 21 21 21 21 21 21 21 21 21 21 21 21 21 21 21 21 21 21 21 21 21 21 21 21 21 21 14 10 18 11 11 
21 21 21 21 21 21 21 21 21 21 21 21 21 21 21 21 21 21 21 21 21 21 21 14 13 13 15 21 21 21 21 21 21 21 21 21 21 21 21 21 21 21 21 21 21 8 11 11 11 25 
21 21 21 21 21 21 21 14 13 13 13 15 21 21 21 21 21 21 21 21 21 21 21 8 11 3 12 15 21 21 21 21 21 21 21 21 21 21 21 21 21 21 21 21 21 8 11 3 11 1 
21 21 21 21 21 21 21 8 11 11 11 12 15 21 21 21 21 21 21 21 21 21 21 17 6 5 11 9 21 21 21 21 21 21 21 21 21 21 21 21 21 21 21 21 21 8 11 11 18 11 
21 21 21 21 21 21 14 10 11 18 2 11 12 15 21 21 21 21 21 21 21 21 21 21 21 17 6 16 21 21 21 21 21 21 21 21 21 21 21 21 21 21 21 21 21 17 5 11 11 2 
21 21 21 21 21 21 8 11 11 25 11 18 11 9 21 21 21 21 21 21 21 21 21 21 21 21 21 21 21 21 21 21 21 21 21 21 21 21 14 15 21 21 21 21 21 21 17 5 11 11 
21 21 21 21 21 21 8 2 11 1 11 11 7 16 21 21 21 21 21 21 21 21 21 21 21 21 21 21 21 21 21 21 21 21 21 14 13 13 10 12 15 21 21 21 21 21 21 17 6 6 
21 21 21 21 21 21 17 5 11 18 11 7 16 21 21 21 21 21 14 13 13 13 13 13 13 13 13 13 13 13 13 13 13 13 13 10 25 11 11 11 12 15 21 21 21 21 21 21 21 21 
21 21 21 21 21 21 21 8 11 7 6 16 21 21 21 21 14 13 10 11 11 11 11 25 54 11 3 11 11 11 11 4 11 11 11 2 1 11 3 11 11 12 15 21 21 21 21 21 21 21 
21 21 21 21 21 21 21 17 6 16 21 21 21 21 14 13 10 11 140 149 146 11 3 1 65 11 140 149 149 149 149 149 149 149 149 149 149 149 146 11 11 11 12 15 21 21 21 21 21 21 
21 21 21 21 21 21 21 21 21 21 21 21 21 14 10 11 11 140 141 23 143 146 11 11 65 11 144 22 24 22 22 22 22 22 23 22 22 22 143 149 149 146 25 9 21 21 21 21 21 21 
21 21 21 21 21 21 21 21 21 21 21 21 14 10 11 4 11 144 24 22 22 147 2 11 65 11 145 150 150 151 23 142 150 150 150 150 151 22 24 22 22 147 1 12 15 21 21 21 21 21 
21 21 21 21 21 21 21 21 21 21 21 21 8 11 11 11 11 145 151 23 24 147 11 11 65 11 4 11 11 144 22 147 11 11 3 11 145 150 150 151 22 147 11 4 9 21 21 21 21 21 
21 21 21 21 21 21 21 21 21 21 21 14 10 11 25 11 2 11 144 22 142 148 11 11 66 60 60 60 61 144 24 147 59 60 60 60 64 11 11 144 24 147 11 11 9 21 21 21 21 21 
21 21 21 21 21 21 21 21 21 21 21 8 11 11 1 11 11 11 144 24 147 11 3 11 65 11 11 11 11 144 22 147 11 11 2 11 65 11 11 144 22 147 11 7 16 21 21 21 21 21 
13 13 13 13 13 13 15 21 21 21 21 8 11 11 11 4 11 11 144 22 147 11 11 11 65 11 2 11 11 144 22 147 11 3 11 11 65 25 11 144 23 147 11 9 21 21 21 21 21 21 
11 11 11 11 11 11 12 13 13 13 15 8 11 3 140 149 149 149 141 22 143 149 146 4 58 11 140 149 149 141 22 143 149 149 146 11 65 1 11 144 22 147 11 9 21 21 21 21 21 21 
11 4 11 11 11 11 11 11 4 11 12 10 11 11 144 22 23 22 22 24 22 22 143 149 149 149 141 22 22 24 22 22 23 22 147 11 65 140 149 141 22 147 11 12 13 13 13 13 15 21 
11 11 11 108 11 11 3 11 11 11 11 25 11 11 144 22 24 22 23 22 23 22 22 22 24 22 22 22 23 22 22 22 22 24 147 11 65 144 22 22 22 147 11 11 11 11 11 4 12 15 
11 108 106 106 11 108 11 11 2 11 11 1 11 11 145 150 150 150 151 22 22 24 142 150 150 150 151 22 22 22 22 22 22 22 147 11 65 144 24 142 150 148 2 11 11 11 3 11 11 12 
114 114 114 114 114 114 114 113 11 107 11 25 11 11 11 4 11 11 145 150 150 150 148 11 65 11 144 24 22 23 22 24 23 22 147 11 65 144 22 147 11 11 11 4 11 25 11 11 25 11 
100 100 100 100 100 100 100 105 114 113 106 1 11 11 11 11 2 11 11 11 11 11 11 11 69 11 144 22 22 22 22 142 150 150 148 2 65 144 22 147 11 11 11 11 11 1 11 11 1 106 
100 100 100 100 100 100 100 100 100 105 114 113 106 11 11 11 11 11 25 11 11 11 11 4 65 11 145 150 150 150 150 148 11 3 11 11 65 144 22 147 3 11 11 106 11 11 106 115 114 114 
100 100 102 101 101 101 103 100 100 100 100 105 114 113 11 106 11 11 1 11 3 11 11 11 65 11 2 11 11 25 4 11 11 11 11 11 58 144 23 147 11 106 115 114 114 114 114 104 100 100 
100 100 116 106 107 106 119 103 100 100 100 100 100 105 114 113 11 11 11 11 11 11 11 11 65 11 11 11 11 1 11 106 115 114 114 114 113 30 22 33 115 114 104 100 100 100 100 100 100 100 
100 100 116 106 106 106 106 119 103 100 100 100 100 100 100 105 114 113 11 106 11 11 11 11 58 11 11 106 11 11 115 114 104 100 100 100 116 30 22 33 117 100 100 100 102 101 101 101 103 100 
100 100 105 113 106 106 108 106 117 100 100 100 100 100 100 100 100 105 114 114 114 114 114 114 114 114 114 114 114 114 104 100 100 100 102 101 118 30 24 33 119 101 101 101 118 106 106 106 117 100 
100 100 100 105 113 108 106 106 117 100 100 100 100 100 100 100 100 100 100 100 100 100 100 100 100 100 100 100 100 100 102 101 101 101 118 106 49 30 22 33 106 106 107 106 106 106 106 106 117 100 
100 100 100 100 105 114 114 114 104 100 100 100 100 100 100 102 101 101 101 101 101 101 101 101 101 101 101 101 101 101 118 106 106 106 106 106 49 30 22 33 106 135 120 98 98 84 120 136 117 100 
100 100 100 100 100 100 100 100 100 100 100 100 100 100 100 116 106 115 114 114 113 106 106 106 106 106 107 106 106 106 106 115 114 113 106 106 49 30 23 33 106 139 89 76 76 76 76 121 117 100 
100 100 100 100 100 100 100 100 100 100 100 100 100 100 100 116 106 117 111 111 116 106 106 106 108 108 106 106 106 115 114 104 100 105 113 106 49 30 22 33 106 139 76 76 76 76 76 121 117 100 
100 100 100 100 100 100 100 100 100 100 100 100 100 100 102 118 106 117 111 102 118 106 106 107 106 106 106 106 107 117 100 100 100 100 116 106 49 30 22 33 106 139 76 76 76 76 76 121 117 100 
100 100 100 102 101 103 100 100 100 100 100 100 100 102 118 106 106 119 101 118 106 106 108 106 106 106 108 106 106 119 101 103 100 100 116 106 49 30 22 33 106 139 76 76 76 76 76 121 117 100 
100 100 100 116 106 117 100 100 100 100 102 101 101 118 106 106 106 106 106 106 106 106 106 106 106 106 106 106 106 106 106 119 103 100 116 106 49 30 24 33 106 124 84 70 78 70 84 125 117 100 
100 100 100 116 107 117 100 100 100 100 116 106 106 108 108 106 106 108 106 108 106 106 106 106 106 108 106 108 106 108 106 106 119 101 118 106 49 30 23 29 35 35 35 27 22 33 106 106 117 100 
100 100 102 118 106 117 100 100 100 100 116 106 106 106 106 106 106 106 106 106 106 106 107 107 106 108 108 106 106 108 106 106 106 106 106 106 49 30 22 22 22 23 22 24 22 33 106 106 117 100 
100 100 116 106 106 117 100 100 100 102 118 106 106 108 106 106 106 107 106 106 106 108 106 106 106 106 106 106 106 107 106 106 106 106 106 106 49 31 36 36 36 36 36 36 36 34 106 106 117 100 
100 102 118 108 106 119 103 100 100 116 106 106 106 106 106 106 106 106 106 108 106 106 106 106 106 106 106 106 106 106 106 106 106 106 106 106 39 44 44 44 44 44 44 41 106 43 44 41 117 100 
100 116 106 106 106 107 117 100 100 116 106 106 106 107 106 106 106 106 106 106 106 106 106 106 106 106 106 106 106 106 106 106 106 106 106 106 106 106 106 106 106 106 106 106 106 106 106 106 117 100 
100 105 114 114 113 106 117 100 100 116 106 108 106 106 106 107 106 106 106 115 114 114 114 113 106 106 106 106 106 106 107 107 106 106 107 106 106 106 108 106 106 106 106 106 106 106 106 106 117 100 
100 100 100 100 105 114 104 100 100 116 106 106 106 106 106 106 106 106 115 104 100 100 100 105 114 114 113 106 106 106 106 106 106 106 106 106 106 106 106 106 108 106 106 106 106 107 106 106 117 100 
100 100 100 100 100 100 100 100 100 116 106 106 106 106 108 106 106 106 117 100 100 100 100 100 100 100 105 114 113 106 106 106 108 106 106 106 106 107 106 106 106 106 106 106 106 106 106 106 117 100 
100 100 100 100 100 100 100 100 100 116 106 106 108 106 106 106 106 106 117 100 100 100 100 100 100 100 100 100 105 113 106 106 106 106 106 106 106 106 106 106 106 107 107 106 106 106 106 115 104 100 
100 100 100 100 100 100 100 100 100 116 106 106 106 106 106 106 107 106 119 103 100 100 100 100 100 100 100 100 100 116 106 106 106 106 106 106 106 106 106 108 106 106 106 106 106 106 115 104 100 100 
100 100 100 100 100 100 100 100 100 105 114 114 114 114 114 114 114 114 114 104 100 100 100 100 100 100 100 100 100 105 114 114 114 114 114 114 114 114 114 114 114 114 114 114 114 114 104 100 100 100 
100 100 100 100 100 100 100 100 100 100 100 100 100 100 100 100 100 100 100 100 100 100 100 100 100 100 100 100 100 100 100 100 100 100 100 100 100 100 100 100 100 100 100 100 100 100 100 100 100 100 
