19 19 19 19 21 21 21 21 21 21 21 19 19 21 21 21 19 19 19 19 19 19 19 19 19 19 19 19 19 19 19 19 19 19 19 19 19 19 19 19 19 19 19 19 19 19 19 19 19 19 
19 19 19 19 21 21 21 21 21 21 21 21 21 21 21 21 21 19 19 19 19 19 19 19 19 19 19 19 19 19 19 19 19 19 19 19 19 19 19 19 19 19 19 19 19 19 19 19 19 19 
19 19 19 19 21 21 21 21 21 21 21 21 21 21 21 21 21 19 19 19 19 19 19 19 19 19 19 19 19 19 19 19 19 19 19 19 19 19 19 19 19 19 19 19 19 19 19 19 19 19 
19 19 19 19 19 21 19 19 19 19 19 19 19 21 19 19 19 14 13 13 13 13 15 19 19 19 19 20 20 20 19 19 19 19 19 19 19 19 19 19 19 19 19 19 19 19 19 19 19 19 
19 19 19 19 19 21 14 13 13 13 15 21 21 21 14 13 13 10 3 18 18 11 12 13 13 15 20 20 14 13 13 13 13 15 21 21 21 21 14 13 13 13 13 15 21 21 19 19 19 19 
19 19 19 19 19 21 8 25 18 18 12 13 15 20 8 2 11 18 11 18 18 18 3 18 2 12 13 13 10 18 18 18 11 12 13 15 19 14 10 18 2 18 18 12 15 21 19 19 19 19 
19 19 19 19 19 19 8 1 4 18 3 18 9 20 8 25 25 25 25 25 25 25 25 18 11 11 18 3 18 18 18 11 2 18 18 9 19 8 18 11 18 11 4 18 12 15 19 19 19 19 
19 19 19 19 19 19 8 2 18 11 18 18 9 20 8 1 1 1 1 1 1 1 1 18 18 4 18 18 18 18 11 18 4 18 18 9 19 8 18 3 18 18 18 18 18 9 19 19 19 19 
19 19 19 19 19 19 8 18 18 18 18 18 9 20 8 22 23 22 24 22 22 22 23 25 18 11 11 11 23 22 23 24 22 18 3 9 19 8 18 11 18 18 11 11 18 9 19 19 19 19 
19 19 19 19 14 13 10 4 18 24 23 22 12 13 10 22 24 22 22 23 22 22 22 1 18 11 11 11 22 23 22 22 23 18 18 12 13 10 18 18 18 2 18 18 18 9 19 19 19 19 
19 19 19 19 8 25 18 18 18 22 23 22 23 23 22 22 22 22 22 22 22 24 22 23 22 22 24 22 22 24 22 23 24 22 22 23 22 24 23 11 11 11 11 3 18 9 19 19 19 19 
19 19 19 19 8 1 18 18 2 22 24 23 7 6 5 24 22 23 22 22 24 23 22 25 18 3 11 11 18 11 18 18 11 18 18 7 6 5 18 4 11 18 18 18 7 16 19 19 19 19 
19 19 19 19 8 11 3 11 18 18 18 18 9 20 8 22 22 22 23 22 22 22 22 1 18 11 18 4 11 2 18 3 18 11 18 9 19 17 6 6 6 6 6 6 16 20 20 19 19 19 
19 19 19 19 17 6 6 6 6 6 6 6 16 20 8 25 25 25 25 25 25 25 25 25 25 25 25 25 25 25 25 25 25 25 25 9 19 19 19 19 19 19 19 19 19 20 19 19 19 19 
19 19 19 19 20 20 20 20 20 20 20 20 20 20 8 1 1 1 1 1 1 1 1 1 1 1 1 1 1 1 1 1 1 1 1 12 13 13 13 13 13 13 13 13 15 21 19 19 19 19 
19 19 19 19 19 14 13 13 13 13 13 13 13 13 10 18 18 18 18 18 18 18 18 18 18 18 18 18 18 18 18 18 18 18 18 18 18 18 18 18 18 18 18 7 16 21 19 19 19 19 
19 19 19 19 19 17 5 18 18 18 18 18 18 18 18 18 18 18 18 18 18 18 18 18 18 18 18 18 18 18 18 18 18 18 18 18 18 18 18 18 7 6 6 16 21 21 19 19 19 19 
19 19 19 19 19 19 8 18 18 18 18 18 18 18 18 18 18 18 18 18 18 18 18 18 18 18 18 18 18 18 18 18 18 18 18 18 18 18 18 18 9 21 21 21 21 21 19 19 19 19 
19 19 19 19 19 19 8 18 18 18 18 18 18 18 18 18 18 18 18 18 18 18 18 18 18 18 18 18 18 18 18 18 18 18 18 18 18 18 18 18 9 21 21 21 21 21 19 19 19 19 
19 19 19 19 19 14 10 18 18 18 18 18 18 18 18 18 18 18 18 18 18 18 18 18 18 18 18 18 18 18 18 18 18 18 18 18 18 18 18 7 16 21 21 21 21 21 21 19 19 19 
19 19 19 19 19 8 18 18 18 18 18 18 18 18 18 18 18 18 18 18 18 18 18 18 18 18 18 18 18 18 18 18 18 18 18 18 18 18 18 9 21 21 21 21 21 21 21 19 19 19 
19 19 19 19 14 10 18 18 18 18 18 18 18 18 18 18 18 18 18 18 18 18 18 18 18 18 18 18 18 18 18 18 18 18 18 18 18 18 18 12 15 21 21 21 21 21 19 19 19 19 
19 19 19 19 17 5 18 18 18 18 18 18 18 18 18 18 18 18 18 18 18 18 18 18 18 18 18 18 18 18 18 18 18 18 18 18 18 18 18 18 12 13 13 15 20 20 19 19 19 19 
19 19 19 19 19 8 18 18 18 18 18 18 18 18 18 18 18 18 18 18 18 18 18 18 18 18 18 18 18 18 18 18 18 18 18 18 18 18 18 18 18 18 18 12 15 20 19 19 19 19 
19 19 19 19 19 17 6 6 5 18 18 18 18 18 18 18 18 18 18 18 18 18 18 18 18 18 18 18 18 18 18 18 18 18 18 18 18 18 18 18 18 18 18 18 9 20 19 19 19 19 
19 19 19 19 19 19 19 19 8 18 18 18 18 18 18 18 18 18 18 18 18 18 18 18 18 18 18 18 18 18 18 18 18 18 18 18 18 18 18 18 18 18 18 18 9 20 19 19 19 19 
19 19 19 19 19 19 19 19 17 6 6 5 18 18 18 18 18 18 18 18 18 18 18 18 18 18 18 18 18 18 18 18 18 18 18 18 18 18 18 18 18 18 18 18 12 15 19 19 19 19 
19 19 19 19 19 19 19 19 19 20 20 8 18 18 18 18 18 18 18 18 18 18 18 18 18 18 18 18 18 18 18 18 18 18 18 18 18 18 18 18 18 18 18 18 18 9 19 19 19 19 
19 19 19 19 19 19 19 19 19 19 19 8 18 18 18 18 18 18 18 18 18 18 18 18 18 18 18 18 18 18 18 18 18 18 18 18 18 18 18 18 18 18 18 18 18 9 19 19 19 19 
19 19 19 19 19 19 19 19 19 19 19 8 18 18 18 18 18 18 18 18 18 18 18 18 18 18 18 18 18 18 18 18 18 18 18 18 18 18 18 18 18 18 18 18 18 9 19 19 19 19 
19 19 19 19 19 19 19 19 19 19 14 10 18 18 18 18 18 18 18 18 18 18 18 18 18 18 18 18 18 18 18 18 18 18 18 18 18 18 18 18 18 18 18 18 18 9 19 19 19 19 
19 19 19 19 19 19 19 19 19 14 10 18 18 18 18 18 18 18 18 18 18 18 18 18 18 18 18 18 18 18 18 18 18 18 18 18 18 18 18 18 18 18 7 6 6 16 19 19 19 19 
19 19 19 19 19 19 19 19 19 8 18 18 18 18 18 18 18 18 18 18 18 18 18 18 18 18 18 18 18 18 18 18 18 18 18 18 7 6 6 6 6 6 16 20 20 21 20 20 19 19 
19 19 19 19 19 19 19 19 19 8 18 18 18 18 18 18 18 18 18 18 18 18 18 18 18 18 18 18 18 18 18 11 11 11 7 6 16 20 21 21 21 20 20 20 20 20 20 19 19 19 
19 19 19 19 19 19 19 19 19 17 5 18 18 18 18 18 18 18 18 18 18 18 18 18 18 18 18 18 18 7 6 6 6 6 16 20 20 20 14 13 13 13 13 13 13 15 19 19 19 19 
19 19 19 19 19 19 19 19 19 19 8 18 18 18 18 18 18 18 18 18 18 18 18 18 18 18 18 18 18 9 20 20 20 20 20 20 14 13 10 18 18 18 18 18 18 9 19 19 19 19 
19 19 19 19 19 19 19 19 19 19 8 18 18 18 18 18 18 18 18 18 18 18 18 18 18 18 18 18 18 9 20 14 13 13 13 13 10 18 18 18 18 18 18 18 18 9 19 19 19 19 
19 19 19 19 19 19 19 19 19 19 8 18 18 18 18 18 18 18 18 18 18 18 18 18 18 18 18 18 7 16 20 8 18 18 18 18 18 18 18 18 18 18 18 18 18 9 19 19 19 19 
19 19 19 19 19 19 19 19 19 14 10 18 18 18 18 18 18 18 18 18 18 18 18 18 18 18 18 18 9 20 20 8 18 18 18 18 18 18 18 18 18 18 18 18 7 16 19 19 19 19 
19 19 19 19 19 20 20 20 19 8 18 18 18 18 18 18 18 18 18 18 18 18 18 18 18 18 18 18 12 13 13 10 18 18 18 18 18 18 18 18 18 18 18 18 9 21 19 19 19 19 
19 19 19 19 20 20 19 20 19 17 5 18 18 18 18 18 18 18 18 18 18 18 18 18 18 18 11 11 11 11 11 11 11 18 18 18 18 18 18 18 18 18 18 18 9 21 19 19 19 19 
19 19 20 20 20 20 20 20 19 19 8 18 18 18 18 18 18 18 18 18 18 18 18 18 18 18 18 18 7 6 5 18 18 18 18 18 18 18 18 18 18 18 18 18 9 21 19 19 19 19 
19 19 20 19 20 20 20 20 19 19 8 18 18 18 18 18 18 18 18 18 18 18 18 18 18 18 18 7 16 20 8 18 18 18 18 18 18 18 18 18 18 18 18 7 16 21 19 19 19 19 
19 19 20 20 20 20 20 19 19 19 8 18 18 18 18 18 18 18 18 18 18 18 18 18 18 18 18 9 20 20 8 18 18 18 18 18 18 18 18 18 18 18 18 9 20 20 19 19 19 19 
19 19 19 19 20 20 20 20 19 19 17 5 18 18 18 18 18 18 18 18 18 7 6 6 6 5 11 9 20 14 10 18 18 18 18 7 6 6 6 6 5 18 18 9 20 20 19 19 19 19 
19 19 19 19 19 19 20 20 19 19 20 17 6 6 6 6 5 18 18 18 7 16 19 19 19 17 6 16 20 8 18 18 7 6 6 16 19 19 19 19 17 6 6 16 20 20 19 19 19 19 
19 19 19 19 19 19 19 19 19 19 19 19 19 19 19 19 17 6 6 6 16 19 19 19 19 19 19 19 20 17 6 6 16 19 19 19 19 19 19 19 19 19 19 19 19 20 19 19 19 19 
19 19 19 19 19 19 19 19 19 19 19 19 19 19 19 19 19 19 19 19 19 19 19 19 19 19 19 19 19 19 19 19 19 19 19 19 19 19 19 19 19 19 19 19 19 19 19 19 19 19 
19 19 19 19 19 19 19 19 19 19 19 19 19 19 19 19 19 19 19 19 19 19 19 19 19 19 19 19 19 19 19 19 19 19 19 19 19 19 19 19 19 19 19 19 19 19 19 19 19 19 
19 19 19 19 19 19 19 19 19 19 19 19 19 19 19 19 19 19 19 19 19 19 19 19 19 19 19 19 19 19 19 19 19 19 19 19 19 19 19 19 19 19 19 19 19 19 19 19 19 19 
