19 19 19 19 21 21 21 21 21 21 21 19 19 21 21 21 19 19 19 19 19 19 19 19 19 19 19 19 19 19 19 19 19 19 19 19 19 19 19 19 19 19 19 19 19 19 19 19 19 19 
19 19 19 19 21 21 21 21 21 21 21 21 21 21 21 21 21 19 19 19 19 19 19 19 19 19 19 19 19 19 19 19 19 19 19 19 19 19 19 19 19 19 19 19 19 19 19 19 19 19 
19 19 19 19 21 21 21 21 21 21 21 21 21 21 21 21 21 19 19 19 19 19 19 19 19 19 19 19 19 19 19 19 19 19 19 19 19 19 19 19 19 19 19 19 19 19 19 19 19 19 
19 19 19 19 19 21 19 19 19 19 19 19 19 21 19 19 19 14 13 13 13 13 15 19 19 19 19 20 20 20 19 19 19 19 19 19 19 19 19 19 19 19 19 19 19 19 19 19 19 19 
19 19 19 19 19 21 14 13 13 13 15 21 21 21 14 13 13 10 18 18 18 18 12 13 13 15 20 20 14 13 13 13 13 15 21 21 21 21 14 13 13 13 13 15 21 21 19 19 19 19 
19 19 19 19 19 21 8 18 18 18 12 13 13 13 10 18 18 18 18 18 18 18 18 18 18 12 13 13 10 18 18 18 18 12 13 13 13 13 10 18 18 18 18 12 15 21 19 19 19 19 
19 19 19 19 19 19 8 18 18 18 18 18 18 18 18 18 18 18 18 18 18 18 18 18 18 18 18 18 18 18 18 18 18 18 18 18 18 18 18 18 18 18 18 18 12 15 19 19 19 19 
19 19 19 19 19 19 8 18 18 18 18 18 18 18 18 18 18 18 18 18 18 18 18 18 18 18 18 18 18 18 18 18 18 18 18 18 18 18 18 18 18 18 18 18 18 9 19 19 19 19 
19 19 19 19 19 19 8 18 18 18 18 18 18 18 18 18 18 18 18 18 18 18 18 18 18 18 18 18 18 18 18 18 18 18 18 18 18 18 18 18 18 18 18 18 18 9 19 19 19 19 
19 19 19 19 14 13 10 18 18 18 18 18 18 18 18 18 18 18 18 18 18 18 18 18 18 18 18 18 18 18 18 18 18 18 18 18 18 18 18 18 18 18 18 18 18 9 19 19 19 19 
19 19 19 19 8 11 18 18 18 18 2 18 18 18 18 18 18 18 18 18 18 18 18 18 18 18 18 18 18 18 18 18 18 18 18 18 18 18 18 18 18 18 18 18 18 9 19 19 19 19 
19 19 19 19 8 11 18 18 18 18 18 18 18 18 18 18 18 18 18 18 18 18 18 18 18 18 18 18 18 18 18 18 18 18 18 18 18 18 18 18 18 18 18 18 7 16 19 19 19 19 
19 19 19 19 8 11 18 18 18 18 18 18 18 18 18 18 18 18 18 18 18 18 18 18 18 18 18 18 18 18 18 18 18 18 18 18 18 18 18 18 18 18 18 18 9 20 20 19 19 19 
19 19 19 19 8 11 18 18 18 18 18 18 18 18 18 18 18 18 18 18 18 18 18 18 18 18 18 18 18 18 18 18 18 18 18 18 18 18 18 18 18 18 18 18 9 20 19 19 19 19 
19 19 19 19 17 5 18 18 18 18 18 18 18 18 18 18 18 18 18 18 18 18 18 18 18 18 18 18 18 18 18 18 18 18 18 18 18 18 18 18 18 18 18 18 9 21 19 19 19 19 
19 19 19 19 19 8 18 18 18 18 18 18 18 18 18 18 18 18 18 18 18 18 18 18 18 18 18 18 18 18 18 18 18 18 18 18 18 18 18 18 18 18 18 7 16 21 19 19 19 19 
19 19 19 19 19 17 5 18 18 18 18 18 18 18 18 18 18 18 18 18 18 18 18 18 18 18 18 18 18 18 18 18 18 18 18 18 18 18 18 18 7 6 6 16 21 21 19 19 19 19 
19 19 19 19 19 19 8 18 18 18 18 18 18 18 18 18 18 18 18 18 18 18 18 18 18 18 18 18 18 18 18 18 18 18 18 18 18 18 18 18 9 21 21 21 21 21 19 19 19 19 
19 19 19 19 19 19 8 18 18 18 18 18 18 18 18 18 18 18 18 18 18 18 18 18 18 18 18 18 18 18 18 18 18 18 18 18 18 18 18 18 9 21 21 21 21 21 19 19 19 19 
19 19 19 19 19 14 10 18 18 18 18 18 18 18 18 18 18 18 18 18 18 18 18 18 18 18 18 18 18 18 18 18 18 18 18 18 18 18 18 7 16 21 21 21 21 21 21 19 19 19 
19 19 19 19 19 8 18 18 18 18 18 18 18 18 18 18 18 18 18 18 18 18 18 18 18 18 18 18 18 18 18 18 18 18 18 18 18 18 18 9 21 21 21 21 21 21 21 19 19 19 
19 19 19 19 14 10 18 18 18 18 18 18 18 18 18 18 18 18 18 18 18 18 18 18 18 18 18 18 18 18 18 18 18 18 18 18 18 18 18 12 15 21 21 21 21 21 19 19 19 19 
19 19 19 19 17 5 18 18 18 18 18 18 18 18 18 18 18 18 18 18 18 18 18 18 18 18 18 18 18 18 18 18 18 18 18 18 18 18 18 18 12 13 13 15 20 20 19 19 19 19 
19 19 19 19 19 8 18 18 18 18 18 18 18 18 18 18 18 18 18 18 18 18 18 18 18 18 18 18 18 18 18 18 18 18 18 18 18 18 18 18 18 18 18 12 15 20 19 19 19 19 
19 19 19 19 19 17 6 6 5 18 18 18 18 18 18 18 18 18 18 18 18 18 18 18 18 18 18 18 18 18 18 18 18 18 18 18 18 18 18 18 18 18 18 18 9 20 19 19 19 19 
19 19 19 19 19 19 19 19 8 18 18 18 18 18 18 18 18 18 18 18 18 18 18 18 18 18 18 18 18 18 18 18 18 18 18 18 18 18 18 18 18 18 18 18 9 20 19 19 19 19 
19 19 19 19 19 19 19 19 17 6 6 5 18 18 18 18 18 18 18 18 18 18 18 18 18 18 18 18 18 18 18 18 18 18 18 18 18 18 18 18 18 18 18 18 12 15 19 19 19 19 
19 19 19 19 19 19 19 19 19 20 20 8 18 18 18 18 18 18 18 18 18 18 18 18 18 18 18 18 18 18 18 18 18 18 18 18 18 18 18 18 18 18 18 18 18 9 19 19 19 19 
19 19 19 19 19 19 19 19 19 19 19 8 18 18 18 18 18 18 18 18 18 18 18 18 18 18 18 18 18 18 18 18 18 18 18 18 18 18 18 18 18 18 18 18 18 9 19 19 19 19 
19 19 19 19 19 19 19 19 19 19 19 8 18 18 18 18 18 18 18 18 18 18 18 18 18 18 18 18 18 18 18 18 18 18 18 18 18 18 18 18 18 18 18 18 18 9 19 19 19 19 
19 19 19 19 19 19 19 19 19 19 14 10 18 18 18 18 18 18 18 18 18 18 18 18 18 18 18 18 18 18 18 18 18 18 18 18 18 18 18 18 18 18 18 18 18 9 19 19 19 19 
19 19 19 19 19 19 19 19 19 14 10 18 18 18 18 18 18 18 18 18 18 18 18 18 18 18 18 18 18 18 18 18 18 18 18 18 18 18 18 18 18 18 7 6 6 16 19 19 19 19 
19 19 19 19 19 19 19 19 19 8 18 18 18 18 18 18 18 18 18 18 18 18 18 18 18 18 18 18 18 18 18 18 18 18 18 18 7 6 6 6 6 6 16 20 20 21 20 20 19 19 
19 19 19 19 19 19 19 19 19 8 18 18 18 18 18 18 18 18 18 18 18 18 18 18 18 18 18 18 18 18 18 11 11 11 7 6 16 20 21 21 21 20 20 20 20 20 20 19 19 19 
19 19 19 19 19 19 19 19 19 17 5 18 18 18 18 18 18 18 18 18 18 18 18 18 18 18 18 18 18 7 6 6 6 6 16 20 20 20 14 13 13 13 13 13 13 15 19 19 19 19 
19 19 19 19 19 19 19 19 19 19 8 18 18 18 18 18 18 18 18 18 18 18 18 18 18 18 18 18 18 9 20 20 20 20 20 20 14 13 10 18 18 18 18 18 18 9 19 19 19 19 
19 19 19 19 19 19 19 19 19 19 8 18 18 18 18 18 18 18 18 18 18 18 18 18 18 18 18 18 18 9 20 14 13 13 13 13 10 18 18 18 18 18 18 18 18 9 19 19 19 19 
19 19 19 19 19 19 19 19 19 19 8 18 18 18 18 18 18 18 18 18 18 18 18 18 18 18 18 18 7 16 20 8 18 18 18 18 18 18 18 18 18 18 18 18 18 9 19 19 19 19 
19 19 19 19 19 19 19 19 19 14 10 18 18 18 18 18 18 18 18 18 18 18 18 18 18 18 18 18 9 20 20 8 18 18 18 18 18 18 18 18 18 18 18 18 7 16 19 19 19 19 
19 19 19 19 19 20 20 20 19 8 18 18 18 18 18 18 18 18 18 18 18 18 18 18 18 18 18 18 12 13 13 10 18 18 18 18 18 18 18 18 18 18 18 18 9 21 19 19 19 19 
19 19 19 19 20 20 19 20 19 17 5 18 18 18 18 18 18 18 18 18 18 18 18 18 18 18 11 11 11 11 11 11 11 18 18 18 18 18 18 18 18 18 18 18 9 21 19 19 19 19 
19 19 20 20 20 20 20 20 19 19 8 18 18 18 18 18 18 18 18 18 18 18 18 18 18 18 18 18 7 6 5 18 18 18 18 18 18 18 18 18 18 18 18 18 9 21 19 19 19 19 
19 19 20 19 20 20 20 20 19 19 8 18 18 18 18 18 18 18 18 18 18 18 18 18 18 18 18 7 16 20 8 18 18 18 18 18 18 18 18 18 18 18 18 7 16 21 19 19 19 19 
19 19 20 20 20 20 20 19 19 19 8 18 18 18 18 18 18 18 18 18 18 18 18 18 18 18 18 9 20 20 8 18 18 18 18 18 18 18 18 18 18 18 18 9 20 20 19 19 19 19 
19 19 19 19 20 20 20 20 19 19 17 5 18 18 18 18 18 18 18 18 18 7 6 6 6 5 11 9 20 14 10 18 18 18 18 7 6 6 6 6 5 18 18 9 20 20 19 19 19 19 
19 19 19 19 19 19 20 20 19 19 20 17 6 6 6 6 5 18 18 18 7 16 19 19 19 17 6 16 20 8 18 18 7 6 6 16 19 19 19 19 17 6 6 16 20 20 19 19 19 19 
19 19 19 19 19 19 19 19 19 19 19 19 19 19 19 19 17 6 6 6 16 19 19 19 19 19 19 19 20 17 6 6 16 19 19 19 19 19 19 19 19 19 19 19 19 20 19 19 19 19 
19 19 19 19 19 19 19 19 19 19 19 19 19 19 19 19 19 19 19 19 19 19 19 19 19 19 19 19 19 19 19 19 19 19 19 19 19 19 19 19 19 19 19 19 19 19 19 19 19 19 
19 19 19 19 19 19 19 19 19 19 19 19 19 19 19 19 19 19 19 19 19 19 19 19 19 19 19 19 19 19 19 19 19 19 19 19 19 19 19 19 19 19 19 19 19 19 19 19 19 19 
19 19 19 19 19 19 19 19 19 19 19 19 19 19 19 19 19 19 19 19 19 19 19 19 19 19 19 19 19 19 19 19 19 19 19 19 19 19 19 19 19 19 19 19 19 19 19 19 19 19 
